00000X00000
0000XXX0000
000XXXXX000
00XXXXXXX00
0XXXXXXXXX0
XXXXXXXXXXX
000XXXXX000
000XXXXX000
000XXXXX000
000XXXXX000
000XXXXX000
000XXXXX000