00XX000000XX00
00XX000000XX00
XXXXXXXXXXXXXX
00XX000000XX00
00XX000000XX00
00XX00XX00XX00
00XX00XX00XX00
00XX000000XX00
00XX000000XX00
XXXXXXXXXXXXXX
00XX000000XX00
00XX000000XX00