000000XX000000
00000XXXX00000
0000XXXXXX0000
000XXXXXXXX000
00XXXXXXXXXX00
0XXXXXXXXXXXX0
XXXXXXXXXXXXXX
0XXXXXXXXXXXX0
00XXXXXXXXXX00
000XXXXXXXX000
0000XXXXXX0000
00000XXXX00000
000000XX000000