XXXXXXXXXXXXX
XXXX00000XXXX
XX0000000XXXX
XX0000000XXXX
XXXX00000XXXX
XXXX00000XXXX
XXXX00000XXXX
XXXX00000XXXX
XXX0000000XXX
XXX0000000XXX
XXXXXXXXXXXXX